..######
..#....E
..#####.
..#.....
..#.#.#.
..#.#...
..#.####
#.......